wwwwwwwwwwwwwwwwwwwww
w...................w
wA...............w..w
w..w................w
w...w...w........+.ww
w...w...............w
www.w2..wwwwwwwwwwwww
w.......w...........w
w.......w....g......w
w.2.................w
w.....2.............w
wwwwwwwwwwwwwwwwwwwww
