wwwwwwwwwwwwwwwwwwwww
w............w......w
w...b.a..a...w......w
w............w.....xw
w............w......w
wwwwwwwwwccwww......w
w.......w...........w
w.......w....bbbbb..w
w.......w....b...b..w
w.......w....b..Ab..w
www..x..w....bbbbb..w
wwwwwwwwwwwwwwwwwwwww
