wwwwwwwwwwwwwwwwwwwww
w..............A....w
w............1......w
w.................m.w
w.......g.........m.w
w...1...............w
w...........m.......w
wwwwwwwwwwwwww00wwwww
w...................w
w.............k.....w
w...................w
wwwwwwwwwwwwwwwwwwwww
