wwwwwwwwwwwwwwwww
w..............ww
w..............ww
wwwwwww......0www
w....1..........w
w.........1.....w
w.....A.........w
w...............w
w...........wwwww
w......0....wwwww
w..............ww
wwwwwwwwwwwwwwwww