wwwwwwwwwwwwwwwwwwwww
w...a...............w
w.......w.a.w.b.....w
w.......w...w.......w
w.......w.a.w.......w
w..x....w...w....a..w
w.b.....f...f.......w
w.......wwwww.......w
w...................w
w..A.a.........b....w
www........x........w
wwwwwwwwwwwwwwwwwwwww
