wwwwwwwwwwwwwwwwwwwww
w......ww...www..hh.w
w......ww...w.......w
w......ww...w.......w
w.x....ww...ww......w
w.....www....ww.....w
w..wwww.......ww....w
w..ww.........w.....w
w..w..........www...w
w..w................w
w.......A..........ew
wwwwwwwwwwwwwwwwwwwww
