wwwwwwwwwwwwwwwwwwwww
w.3.gw....1.w.......w
w..www......w.......w
w...........w.......w
w...............2...w
w...................w
w.......wwwwwwwwwwwww
w.......w.....+.....w
w.......w...........w
w...w...w...........w
wA..w...............w
wwwwwwwwwwwwwwwwwwwww
