wwwwwwwwwwwwwwwwwwwww
w...................w
w...................w
w......1...wwwwwwwwww
w.........m0......g.w
wk........m0........w
w....A....m0........w
w.1....1...wwwwwwwwww
w...................w
w...................w
w...................w
wwwwwwwwwwwwwwwwwwwww
