wwwwwwwwwwwwwwwwwwwww
w.......A...........w
w...................w
w.b.................w
w.......fffff.......w
w..b..a.f.x.f.......w
w.......f..xf.......w
w.......fffff...a...w
w...................w
w............b......w
www.................w
wwwwwwwwwwwwwwwwwwwww
