wwwwwwwwwwwwwwwwwwwww
w............w......w
w...A........w.....ww
w............w....1gw
w............w.....ww
w............w......w
w............w......w
w...................w
w...................w
w..k................w
w...................w
wwwwwwwwwwwwwwwwwwwww
